11111111111111111
1000001C10000P001
100000010000C0001
10000000E00000001
11111111111111111