111111
10VE01
1VCV01
10VP01
111111