111111
10VC01
1VEV01
10VP01
111111