111111111111
100010P00001
100010000001
100010CCCCC1
1CCC000000E1
111111111111