11111111111111111
1000000C000000001
10000000000000001
1000000000000E001
11111111111111111