111111111111111111
1000000000000001
1PCE00000000000000000000000000000000000000000000000000000000001
111111111111111111100001
1111111111111111111