11111111111111111
1000001P10000E001
100000010000C0001
10000000000000001
11111111111111111