111111
10VC01
1VPV01
10VE01
111111