111111111111111111
1E000C000000000C01
101001010010000011
1010010V1010101001
1P0000000C00C00VV1
111111111111111111